===================================================================
||···················||··················K············+····||······
||···················||··················||==============··||······
||···················||··················||············||··||······
||···················||··················||············||··||······
||···················========|·|=========||············||··||······
||··························||·||········||············||··||······
||··························||·||········||············||··||······
||··························||·||········||············||··||······
||··················========||·||········||············||··========
||·····························||········||············||·······(0)
||·····························||········||············============
||··················=============········||························
||·@·····································||························
===================================================================
