				FIGHT!
·······································
····=====·····················|===|····
····||@||=====================||%||····
····=====·····················|===|····
····Player···················Monster···
·······································
