===================================================================
||···················||··················||················||······
||···················||···K··············||==============··||······
||···················||··················||············||··||······
||···················||··················||············||··||······
||···················========···=========||············||··||······
||·························||···||·······||············||··||······
||·························||···||·······||············||··||······
||·························||···||·······||············||··||······
||··················=========···||·······||············||··========
||······························||·······||············||·······(0)
||······························||·······||············============
||··················==============·······||························
||·@·····································||························
===================================================================
