===================================================================
||···················||··················Ж············?····||······
||···················||··················||=============||·||······
||···················||··················||·············||·||······
||···················||··················||·············||·||······
||···················========|·|=========||·············||·||······
||··························||·||········||·············||·||······
||··························||·||········||·············||·||······
||··························||?||········||·············||·||······
||··················========||·||········||·············||·||======
||·····························||········||·············||······(0)
||·····························||········||·············===========
||··················=============········||························
||·@·····································||························
===================================================================
