======================
||··················||
||··················||
||··················||
||·@················||
======================
